11111111111111111111111111111111111111
1111111111111111PC0000000000000000E111
11111111111111111111111111111111111111