1111111111111
10E1111000001
1000001111101
10P010000C001
100010000C001
1111111111111
