1111111111111
10E1111000001
1000001111101
1P0011100C001
1111111111111
