1111111111111
1001111000001
10E0001111101
10P00C0C00001
1000100000001
1111111111111
